###############################################
#BBBBBBBBBBBBBBBBBBBBBBBBBBBBBBBBBBBBBBBBBBBBB#
#BBBBBBBBBBBBBBBBBBBBBBBBBBBBBBBBBBBBBBBBBBBBB#
#BBBBBBBBBBBBBBBBBBBBBBBBBBBBBBBBBBBBBBBBBBBBB#
#BBBBBBBBBBBBBBBBBBBBBBBBBBBBBBBBBBBBBBBBBBBBB#
#BBBBBBB#######BBBB#BBBBB#####B#####BBBBBBBBBB#
#BBBBBBB#BBBBBBBBBB#BBBBB#BBBB#BBBB#BBBBBBBBBB#
#BBBBBBB#######BBBB#BBBBB#BBBB#BBBB#BBBBBBBBBB#
#BBBBBBB#BBBBBBBBBB#BBBBB#BBBBBBBBB#BBBBBBBBBB#
#BBBBBBB#BBBBBBBBBB#BBBBB#BBBBBBBBB#BBBBBBBBBB#
#BBBBBBBBBBBBBBBBBBBBBBBBBBBBBBBBBBBBBBBBBBBBB#
#BBBBBBBBBBBBBBBBBBBBBBBBBBBBBBBBBBBBBBBBBBBBB#
#BBBBBBBBBBBBBBBBBBBBBBBBBBBBBBBBBBBBBBBBBBBBB#
#BBBBBBBBBBBBBBBBBBBBBBBBBBBBBBBBBBBBBBBBBBBBB#
#BBBBBBBBBBBBBBBBBBBBBBBBBBBBBBBBBBBBBBBBBBBBB#
#BBBBBBBBBBBBBBBBBBBBBBBBBBBBBBBBBBBBBBBBBBBBB#
#BBBBBBBBBBBBBBBBBBBBBBBBBBBBBBBBBBBBBBBBBBBBB#
#BBBBBBBBBBBBBBBBBBBBBBBBBBBBBBBBBBBBBBBBBBBBB#
###############################################